α|Α
ά|Ά
β|Β
γ|Γ
δ|Δ
ε|Ε
έ|Έ
ζ|Ζ
η|Η
ή|Ή
θ|Θ
ι|Ι
ί|Ί
κ|Κ
λ|Λ
μ|Μ
ν|Ν
ξ|Ξ
ο|Ο
ό|Ό
π|Π
ρ|Ρ
σ|Σ
τ|Τ
υ|Υ
ύ|Ύ
φ|Φ
χ|Χ
ψ|Ψ
ω|Ω
ώ|Ώ